{
	"name": "Field",
	"background": "Images/background.png",
	"foreground": "Images/foreground.png",
	"gravity": "-9.81",
	"ground": [
		[ 0, 1146, 66, 1125, 201, 1146, 305, 1215, 306, 1688, 0, 1688],
		[305, 1215, 410, 1341, 475, 1361, 568, 1361, 568, 1688, 306, 1688],
		[568, 1361, 606, 1331, 668, 1220, 694, 1185, 694, 1688, 568, 1688],
		[694, 1185, 734, 1166, 877, 1175, 961, 1215, 961, 1688, 694, 1688],
		[961, 1215, 979, 1224, 1020, 1224, 1085, 1157, 1085, 1688, 961, 1688],
		[1085, 1157, 1223, 989, 1325, 942, 1728, 952, 1728, 1688, 1085, 1688],
		[1728, 952, 1794, 992, 1976, 1206, 1997, 1225, 1997, 1688, 1728, 1688],
		[1997, 1225, 2038, 1231, 2080, 1209, 2169, 1169, 2169, 1688, 1997, 1688],
		[2169, 1169, 2303, 1175, 2354, 1222, 2421, 1340, 2421, 1688, 2169, 1688],
		[2421, 1340, 2441, 1361, 2493, 1369, 2536, 1369, 2536, 1688, 2421, 1688],
		[2536, 1369, 2594, 1354, 2631, 1331, 2722, 1207, 2722, 1688, 2536, 1688],
		[2722, 1207, 2795, 1160, 2889, 1131, 3000, 1136, 3000, 1688, 2722, 1688]
	]
}